# Points to consider long term
# Some of the test passwords tried
# I need to sort out formatting
# I need to set boundaries on what can be included
# Settings times different from usernames
# Securing the use of symbols in usernames, this needs to ba addressed 


Username or Email: test@test.com	Random Password: 4!m1nQWEfI+!z}{9,8{
Username or Email: lee@test-12:50.com	Random Password: {uwhcLMrhP!9CAc6g}b
Username or Email: test@12:54.com	Random Password: '/Q}T|o9dbIV}"X.qGy
Username or Email: lee@12:57.com	Random Password: 2xaWSx'|fqqK:7GNH"5
Random Password: 3r}u4,<uUssFE{rMW{@
Username or Email: no	Random Password: 3r}u4,<uUssFE{rMW{@
Random Password: wP=y1magIshagsicK9C
Username or Email: no	Random Password: wP=y1magIshagsicK9C
#######################
###################

Username or Email: test@13:03.com	Random Password: C90k@lO,34"I1LOB,CG
Username or Email: no	Random Password: ;elwX/3A7DBeu:"uLQC
Username or Email: n	Random Password: vQ2RY4:}'Z"s'h:hk58
Username or Email: sdsdf	Random Password: '!pERK}RG5zr"}.9q;w
Username or Email: na	Random Password: E/f:+Ka3:v.MBon9/R1

#########################
########################

Username or Email: no	Random Password: !Z}Hlzd1eU
Username or Email: na	Random Password: J9FzEXg7?W
Username or Email: y	Random Password: ;h@5d"+Pk:
Username or Email: yes	Random Password: "<;'13BeZS
Username or Email: yes	Random Password: "<;'13BeZS
Username or Email: yeshappy@test.com	Random Password: t038<:6"zO
Username or Email: no@test.com	Random Password: UywX'9>c|KoC_69Pxg"
Username or Email: no14:00@test.com	Random Password: ZJG7Jeqg9ay3TQhdNhJ
Username or Email: y	Random Password: <}AvCf4Kr"!'Ak
Username or Email: y	Random Password: <}AvCf4Kr"!'Ak
Username or Email: test-18:35@test.com	Random Password: >j59}:'C3;tgCFasI3W
Username or Email: tgdsgsgtgtgsrtsrthrsthrsth	Random Password: '9sX{r8ga!XXOZ'!f>}
Username or Email: csdccfvsfarargfa@egaegaegr.com	Random Password: :5Ic9Qd1a"p@'B1e>
Username or Email: fewfewferfefe@wfwef.com	Random Password: ,EluN}egq:uva?A8_
Username or Email: 34r2q34q3gtq3@gq345gq3	Random Password: D:+62?SK2MLxvjfnG
Username or Email: test18:41@text.com	Random Password: !FFG7QWG0IFiy1,RwuK
Username or Email: test_18:43@test.com	Random Password: 6sN4y"OCp:|U_"v"H/6
Username or Email: test_18:44@test.com	Random Password: .9>RZC'lr9M';.B306W
Username or Email: test@1844.com	Random Password: fbw+=2=135A_;5!Y{LT
Username or Email: test18:45@test.com	Random Password: :d<;tXQ!AK"jr1P,Uws
Username or Email: egyveyvye	Random Password: >tn8e'vpo5{XR/+ug6r
Username or Email: fwffe45g4	Random Password: zc7'W?>Y"h27h4c'm?b
Username or Email: fef33ef3f3fasg	Random Password: F?Gf'@'0|'oF=1q;lWq
Username or Email: uhvvbeubvuebuv	Random Password: ;C|v"@'U5F/0=b<VR1M
Username or Email: test@test.com	Random Password: REa<h/rJo2!@d"
Username or Email: updated@18:53_win.com	Random Password: R/TG{,ioeR,ezkNwd/s
Username or Email: updated@18:59_win.com 	Random Password: 5X;HoG'i@vf3OMOu6oC
Username or Email: ifelse_ckech@test.com	Random Password: LdCTGxVYn_i:'I"dZV?
Username or Email: if_else@test_21:42.com	Random Password: pR2ILg=cO0A'gI,zaq+
Username or Email: if_else_check_21:51@test.com	Random Password: cZw3Ico<Swl'|TA_'kn
Username or Email: ifelsecheck@test21:52.com	Random Password: 5pz>t+C=aL4}m'gT|9n
